1111111111111111
1P000000000000E1
1011110111110101
1000010100000101
1011010101110101
1001010101000101
1011010101110101
10000100C0000101
1011111111110101
1000000000000001
1111111111111111
