111111111
1P00000C1
101101001
1000C01E1
101111111
1000000C1
111111111