111111111111111111111111111111
100000000000000000000000000001
101010101010101010101010101001
100000000P00000000000000000001
101010101010101010101010101001
100000000000000000000000000001
101010101010101010101010101001
100000000000000000000000000001
101010101010101010101010101001
100000000000000000000000000001
101010101010101010101010101001
100000000000000000000000000001
101010101010101010101010101001
100000000000000000000000000001
101010101010101010101010101001
100000000000000000000000000001
10000000000000C000000000000001
101010101010101010101010101001
100000000000000000000000000001
101010101010101010101010101001
100000000000000000000000000001
101010101010101010101010101001
100000000000000000000000000001
10000000000000000000000000E001
111111111111111111111111111111
