111111111
1P00000C1
101101001
1000C0101
110111101
10000000E
111111111