1111111111
10000P0001
1011111011
1010000001
1010101011
1011101011
1011101111
1000111C11
1011111101
10000000E1
1111111111